[Jogador]
Nome=Radahn
Classe=Guerreiro

[Ambientes]
Praça Central|na Praça Central da cidade Moonlight.|LESTE=Pousada|SUL=Beco:Chave|OESTE=Floresta|NORDESTE=Taverna|Toxico
Pousada|na Pousada da bela cidade Moonlight.|OESTE=Praça Central|NORTE=Taverna|Toxico
Igreja|na velha igreja da cidade Moonlight.|SUL=Praça Central
Beco|em um beco escuro.|NORTE=Praça Central|BAIXO=Esgoto|Escuro
Floresta|na floresta|LESTE=Praça Central|SUL=Caverna
Cemitério|no cemitério sombrio|SUL=Floresta|OESTE=Cabana|LESTE=Portao Trancado|Escuro
Cabana|em uma cabana abandonada|LESTE=Floresta|OESTE=Lago|Escuro
Taverna|na taverna acolhedora.|OESTE=Praça Central|SUL=Pousada
Esgoto|no esgoto escuro e fedorento|CIMA=Beco|NOROESTE=Tunel Esgoto 1|NORTE=Tunel Esgoto 2|NORDESTE=Tunel Esgoto 3|Toxico
Tunel Esgoto 1|em um túnel do esgoto|SUDESTE=Esgoto|LESTE=Tunel Esgoto 2|NORDESTE=Tunel Esgoto 5|NORTE=Tunel Esgoto 4|Toxico
Tunel Esgoto 2|em um túnel do esgoto|OESTE=Tunel Esgoto 1|NORTE=Tunel Esgoto 5|NORDESTE=Tunel Esgoto 6|LESTE=Tunel Esgoto 3|SUL=Esgoto|NOROESTE=Tunel Esgoto 4|Toxico
Tunel Esgoto 3|em um túnel do esgoto|OESTE=Tunel Esgoto 2|NOROESTE=Tunel Esgoto 5|NORTE=Tunel Esgoto 6|Toxico
Tunel Esgoto 4|em um túnel do esgoto|SUL=Tunel Esgoto 1|SUDESTE=Tunel Esgoto 2|NORTE=Tunel Esgoto 7|NORDESTE=Tunel Esgoto 8|LESTE=Tunel Esgoto 5|OESTE=Sala Tesouro|Toxico
Tunel Esgoto 5|em um túnel do esgoto|OESTE=Tunel Esgoto 4|SUL=Tunel Esgoto 2|SUDESTE=Tunel Esgoto 3|NORTE=Tunel Esgoto 8|NORDESTE=Tunel Esgoto 9|LESTE=Tunel Esgoto 6|NOROESTE=Tunel Esgoto 7|SUDOESTE=Tunel Esgoto 1|Toxico
Tunel Esgoto 6|em um túnel do esgoto|OESTE=Tunel Esgoto 5|SUL=Tunel Esgoto 3|SUDOESTE=Tunel Esgoto 2|NORTE=Tunel Esgoto 9|Toxico
Tunel Esgoto 7|em um túnel do esgoto|SUL=Tunel Esgoto 4|SUDESTE=Tunel Esgoto 5|LESTE=Tunel Esgoto 8|Toxico
Tunel Esgoto 8|em um túnel do esgoto|OESTE=Tunel Esgoto 7|SUDOESTE=Tunel Esgoto 4|SUL=Tunel Esgoto 5|SUDESTE=Tunel Esgoto 6|LESTE=Tunel Esgoto 9|Toxico
Tunel Esgoto 9|em um túnel do esgoto|OESTE=Tunel Esgoto 8|SUDOESTE=Tunel Esgoto 5|SUL=Tunel Esgoto 6|NORDESTE=Salao Espera|Toxico
Salao Espera|no salão de espera|SUL=Tunel Esgoto 9|NORTE=Sala Boss
Sala Boss|na sala do boss|SUL=Salao Espera
Sala Tesouro|na sala do tesouro|LESTE=Tunel Esgoto 4
Lago|à beira de um lago tranquilo|LESTE=Cabana
Caverna|em uma caverna escura|NORTE=Floresta|Toxico
Portao Trancado|diante de um portão trancado, necessitando de uma chave especial para abrir|LESTE=Cemitério|SUL=Salao Secreto
Salao Secreto|um salão secreto cheio de tesouros e perigos|NORTE=Portao Trancado

[Itens]
Bosta|uma máscara respiratória que protege contra gases tóxicos|Acessorio|Praça Central|proteger
Terrablade|uma espada lendária da terra|Espada|Praça Central|20.0|100
Pocao_Grande|uma poção que recupera 50 de vida|Pocao|Igreja|5
Chave_De_Ouro|uma chave de ouro com runas antigas gravadas|Consumivel|Praça Central|1
Carta|uma carta velha|Carta|Pousada|Contém pistas sobre a história
Armadura de Ferro|uma armadura de ferro|Armadura|Cabana|50.0|10
Adaga|uma adaga afiada|Adaga|Beco|10.0|100


[Personagens]
Padre|um padre idoso|O padre diz: 'O segredo está na igreja, meu filho.'|Praça Central
Recepcionista|uma recepcionista jovem|A recepcionista diz: 'Bem-vindo à Pousada!'|Pousada
Guarda|um guarda da cidade|O guarda diz: 'Tenha cuidado ao sair da cidade.'|Praça Central
Mendigo|um mendigo sujo|O mendigo diz: 'Você tem algum trocado?'|Beco

[Inimigos]
Esqueleto|um esqueleto assustador|Praça Central|100|10|Bosta, Carta
Zumbi|um zumbi fedido|Caverna|150|15|Pocao_Grande
Lobisomem|um lobisomem feroz|Floresta|100|10
Fantasma|um fantasma assustador|Cemitério|100|10
Aranha Gigante|uma aranha gigante|Caverna|100|10
